10
A.-.-.-.-.-.-.-.-.-
-.-.-.-.-.-.-.-.-.-
-.-.-.-.-.-.-.-.-.-
-.-.-.-.-.G.-.-.-.-
-.-.-.-.-.-.-.-.-.-
-.-.P_G.-.-.-.-.-.-.-
-.-.P.-.-.-.W.-.-.-
-.-.-.-.-.-.-.-.-.-
-.-.-.-.-.-.-.H_P.-.-
-.-.-.-.-.-.-.-.-.-